Nhiều	A
thi_thể	N
là	V
binh_sĩ	N
và	Cc
quan_chức	N
trong	E
chính_quyền	N
cũ	A
bị	V
Taliban	Np
xử_tử	V
.	CH

Sau	L
mỗi	N
lần	V
làm	N
bánh_mì	CH
,	N
chị	R
thường	E
để	E
trong	N
túi	N
giấy	Cc
và	V
dùng	V
được	N
khoảng	M
4	CH
-	M
5	N
bữa	CH
.	Np
	Ny
Trường	Np
ĐH	Np
Giao_thông	R
Vận_tải	A
vẫn	V
chủ_yếu	E
tuyển_sinh	M
bằng	N
2	V
phương_thức	V
là	N
sử_dụng	N
kết_quả	V
kỳ	V
thi	Ny
tốt_nghiệp	Cc
THPT	V
và	N
sử_dụng	V
kết_quả	Ny
học_tập	CH
THPT	N
(	CH
học_bạ	CH
)	Np
.	N

Bằng	N
thuyền_trưởng	M
đường_biển	Cc
hạng	N
V	M
và	E
hạng	N
IV	R
của	V
chị	N
chẳng	P
có	N
giá_trị	V
gì	E
khi	N
đứng	N
trong	N
buồng_lái	V
con	P
tàu	CH
du_lịch	Np
này	V
.	V

Anh	N
đi	V
tìm	CH
thì	N
em	V
trốn	V
,	N
anh	R
đi	V
trốn	Np
em	V
không	V
tìm	E

Sớm	N
thức	A
dậy	CH
ở	N
một	V
nơi	CH
xa	P
.	A

Khi	V
ngủ	V
,	E
tôi	R
liên_tục	V
bị	V
giật_mình	CH
thức_giấc	N
vì	V
không	V
thở	E
được	A
.	N

Tình_trạng	Np
diễn	N
ra	Np
tại	CH
nhiều	Np
đơn_vị	Nc
như	CH
Giao	Ny
Hàng	CH
Tiết_Kiệm	Np
,	CH
Giao	Np
Hàng_Nhanh	CH
,	M
J&T_Express	Nc
,	A
Nhất_Tín_Logistic	V
,	V
Viettel_Post	CH
...	V

Hai	C
đứa	V
nhỏ	P
đột_nhiên	CH
thức_giấc	C
,	R
ngáp	V
dài	CH
rồi	R
nhìn	V
hắn	CH
,	N
như	V
vừa	V
quen_quen	N
,	N
vừa	Np
là_lạ	M
.	CH

Khi	Np
đi	N
đăng_ký	Np
thuyền_viên	V
tàu	N
Bonsai	V
1	N
,	P
Chi_cục	V
Đường_sông	V
phía	E
Nam	N
yêu_cầu	N
người	N
lái	M
tàu	CH
này	P
phải	V
có	V
bằng	E
thuyền_trưởng	N
đường_sông	V
hạng	N
1	M
