Nhiều	A
thi_thể	R
là	V
binh_sĩ	N
và	C
quan_chức	N
trong	E
chính_quyền	N
cũ	A
bị	V
Taliban	N
xử_tử	V
.	CH

Sau	CH
mỗi	L
lần	N
làm	V
bánh_mì	N
,	CH
chị	Nc
thường	R
để	V
trong	E
túi	N
giấy	N
và	C
dùng	V
được	V
khoảng	N
4	M
-	CH
5	M
bữa	N
.	CH
	V
Trường	N
ĐH	Np
Giao_thông	Np
Vận_tải	Np
vẫn	R
chủ_yếu	A
tuyển_sinh	V
bằng	E
2	M
phương_thức	N
là	V
sử_dụng	V
kết_quả	N
kỳ	N
thi	V
tốt_nghiệp	V
THPT	N
và	C
sử_dụng	V
kết_quả	N
học_tập	V
THPT	N
(	CH
học_bạ	N
)	CH
.	CH

Bằng	N
thuyền_trưởng	N
đường_biển	N
hạng	N
V	N
và	C
hạng	N
IV	V
của	E
chị	Nc
chẳng	R
có	V
giá_trị	N
gì	P
khi	N
đứng	V
trong	E
buồng_lái	N
con	N
tàu	N
du_lịch	V
này	P
.	CH

Anh	N
đi	V
tìm	V
thì	C
em	N
trốn	V
,	CH
anh	Nc
đi	V
trốn	V
em	N
không	R
tìm	V

Sớm	Np
thức	V
dậy	V
ở	E
một	M
nơi	N
xa	A
.	CH

Khi	Np
ngủ	V
,	CH
tôi	P
liên_tục	R
bị	V
giật_mình	V
thức_giấc	N
vì	E
không	R
thở	V
được	V
.	CH

Tình_trạng	N
diễn	V
ra	V
tại	E
nhiều	A
đơn_vị	N
như	C
Giao	N
Hàng	N
Tiết_Kiệm	Np
,	CH
Giao	Np
Hàng_Nhanh	Np
,	CH
J&T_Express	Np
,	CH
Nhất_Tín_Logistic	Np
,	CH
Viettel_Post	Np
...	CH

Hai	CH
đứa	Nc
nhỏ	A
đột_nhiên	R
thức_giấc	V
,	CH
ngáp	N
dài	A
rồi	R
nhìn	V
hắn	P
,	CH
như	C
vừa	R
quen_quen	V
,	CH
vừa	R
là_lạ	V
.	CH

Khi	Np
đi	V
đăng_ký	V
thuyền_viên	N
tàu	N
Bonsai	N
1	M
,	CH
Chi_cục	N
Đường_sông	N
phía	N
Nam	Np
yêu_cầu	V
người	N
lái	V
tàu	N
này	P
phải	V
có	V
bằng	E
thuyền_trưởng	N
đường_sông	V
hạng	N
1	M
